Oops
An Interactive Fiction by Kunlin
Release 1 / Serial number 220305 / Inform 7 build 6M62 (I6/v6.34 lib 6/12N) SD

Deep Forest
Oops, you are lost in a deep forest. The trees grow so close together that you cannot see the moon or the sky, and no animals or small plants thrive on the ground. It seems dangerous around, so keep your eyes sharp...

and...

try to go somewhere.

wait...

there's a ball in your pocket!

>drop the ball
It rolls suggestively towards the west. You pick it up again before it can get too far ahead of you.

>go west
Witch's Garden
In this garden grow plants that eat insects and plants that eat birds. It is bordered by a bone fence, and the pavements are made of a giant's kneecaps.

In the center of the garden is Witch's hut, which walks on chicken legs. Currently the hut is squatting on the ground.

A beautiful and tasteful plant is in Witch's Garden.

Some plants can even speak!

>drop the ball
It rolls suggestively towards the inside. You pick it up again before it can get too far ahead of you.

* * *

>drop the ball
It rolls suggestively towards the west. You pick it up again before it can get too far ahead of you.

>look at the ball
Whenever you drop this, it rolls in the way you should go.

* * *

Oops
An Interactive Fiction by Kunlin
Release 1 / Serial number 220305 / Inform 7 build 6M62 (I6/v6.34 lib 6/12N) SD

Deep Forest
Oops, you are lost in a deep forest. The trees grow so close together that you cannot see the moon or the sky, and no animals or small plants thrive on the ground. It seems dangerous around, so keep your eyes sharp...

and...

try to go somewhere.

wait...

there's a ball in your pocket!

>go east
You can't go that way.

>go west
Witch's Garden
In this garden grow plants that eat insects and plants that eat birds. It is bordered by a bone fence, and the pavements are made of a giant's kneecaps.

In the center of the garden is Witch's hut, which walks on chicken legs. Currently the hut is squatting on the ground.

A beautiful and tasteful plant is in Witch's Garden.

Some plants can even speak!

>go east
Deep Forest
Oops, you are lost in a deep forest. The trees grow so close together that you cannot see the moon or the sky, and no animals or small plants thrive on the ground. It seems dangerous around, so keep your eyes sharp... and... try to go somewhere!

>go west
Witch's Garden
In this garden grow plants that eat insects and plants that eat birds. It is bordered by a bone fence, and the pavements are made of a giant's kneecaps.

In the center of the garden is Witch's hut, which walks on chicken legs. Currently the hut is squatting on the ground.

A beautiful and tasteful plant is in Witch's Garden.

Some plants can even speak!

* * *

Oops
An Interactive Fiction by Kunlin
Release 1 / Serial number 220305 / Inform 7 build 6M62 (I6/v6.34 lib 6/12N) SD

Deep Forest
Oops, you are lost in a deep forest. The trees grow so close together that you cannot see the moon or the sky, and no animals or small plants thrive on the ground. It seems dangerous around, so keep your eyes sharp...

and...

try to go somewhere.

wait...

there's a ball in your pocket!

>go west
Witch's Garden
In this garden grow plants that eat insects and plants that eat birds. It is bordered by a bone fence, and the pavements are made of a giant's kneecaps.

In the center of the garden is Witch's hut, which walks on chicken legs. Currently the hut is squatting on the ground.

A beautiful and tasteful plant is in Witch's Garden.

Some plants can even speak!

>have a look at the ball
That's not a verb I recognise.

>take the ball
You already have that.

>drop the ball
It rolls suggestively towards the inside. You pick it up again before it can get too far ahead of you.

>go eaast
You can't see any such thing.

>go east
Deep Forest
Oops, you are lost in a deep forest. The trees grow so close together that you cannot see the moon or the sky, and no animals or small plants thrive on the ground. It seems dangerous around, so keep your eyes sharp...

and...

try to go somewhere.

wait...

there's a ball in your pocket!

>drop the ball
The ball rolls around uncertainly and then comes back to sit at your feet with such an apologetic air that you have to pick it back up.

* * *

Oops
An Interactive Fiction by Kunlin
Release 1 / Serial number 220305 / Inform 7 build 6M62 (I6/v6.34 lib 6/12N) SD

Deep Forest
Oops, you are lost in a deep forest. The trees grow so close together that you cannot see the moon or the sky, and no animals or small plants thrive on the ground. It seems dangerous around, so keep your eyes sharp...

and...

try to go somewhere.

wait...

there's a ball in your pocket!

>take it
I'm not sure what 'it' refers to.

>take the ball
You already have that.