TheDoor
An Interactive Fiction by Kunlin
Release 1 / Serial number 220307 / Inform 7 build 6M62 (I6/v6.34 lib 6/12N) SD

Old Mansion
Hello! Welcome to the old mansion. Best of luck, hope you find your way to the trophy! Go inside to enter the Studyroom?

>enter the studyroom
You can't see any such thing.

>go in the studyroom
You can't see any such thing.

>go inside
Studyroom
Welcome to the Study Room! Description of the room: 1. There are no doors to on any of the wall! 2. There is a fireplace, bookshelf, desk and a ladder in the study room. Look around, maybe you find some clues to escape from the room!

>look at the studyroom
You can't see any such thing.

>go outside
Old Mansion
Hello! Welcome to the old mansion. Best of luck, hope you find your way to the trophy! Enter the Studyroom?

>go inside
Studyroom
Welcome to the Study Room! Description of the room: 1. There are no doors to on any of the wall! 2. There is a fireplace, bookshelf, desk and a ladder in the study room. Look around, maybe you find some clues to escape from the room!